舰娘	别名1	别名2	别名3	别名4	别名5	别名6	别名7	别名8	别名9	别名10	别名11	别名12	别名13	别名14	别名15	别名16	别名17	别名18	别名19	别名20
摩耶	Maya	まや
西北风	Maestrale
朝潮	Asashio	あさしお
球磨	Kuma	くま
风云	Kazagumo	かざぐも	風雲
阿奎拉	Aquila	天鹰	阿库娅	鹫座
山城	Yamashiro	やましろ
无畏	Intrepid	美国土豆
晓	Akatsuki	lady	あかつき	暁
朝云	Asagumo	あさぐも	朝雲	赵云
凉风	Suzukaze	すずかぜ	涼風
旗风	Hatakaze	はたかぜ	旗風
时雨	Shigure	しぐれ	大天使	忠犬	時雨
北上	Kitakami	きたかみ	大魔王	春希	超级北上大人
哥特兰	Godland	Gotland	哥特	瑞典轻巡
葛城	Katsuragi	かつらぎ	葛平
曙	Akebono	bono	あけぼの	小叮当	铃铛
那智	Nachi	なち
铃谷	JK	Suzuya	すずや	鈴谷
扶桑	Fusou	ふそう
长门	Nagato	ながと	長門	长萌
衣阿华	Iowa	LowA	爱荷华	鸭华	鸭滑
三日月	Mikaduki	みかづき	三明
满潮	252	Michishio	みちしお	満潮
荒潮	251	Arashio	あらしお
欧根	Eugen	Prinz	Prinz Eugen	布丁	月刊重巡	毆根	飞啊飞啊
萩风	Hagikaze	はぎかぜ	篍风	艹秋风	荻风	获风	萩	萩萩	萩風	阿萩
长良	Nagara	ながら	長良
千岁	Chitose	ちとせ	千歳
高雄	Takao	たかお
甘比尔湾	Bay	GB	Gambier	Gambier Bay	冈比亚	冈比尔	干瘪尔呗	干贝	甘比亚	甘比尔	甘贝尔	贝
神鹰	shinyou	しんよう	沙恩霍斯特
古鹰	Furutaka	ふるたか	古鷹
日振	Hiburi	ひぶり
夕张	Yuubari	ゆうばり	于八日	夕張	意大利帅哥	瓜	蜜瓜
那珂	2411	Naka	なか	偶像
初雪	Hatsuyuki	はつゆき
深雪	Miyuki	みゆき
意大利	Italia	Littorio	利托里奥	呆利	意呆
瑞穗	Mizuho	みずほ	瑞惠	瑞穂
浦波	Uranami	うらなみ
足柄	Ashigara	あしがら	狼姐	饿狼
加贺	Kaga	かが	加賀	正妻空母
滨波	Hamanami	はまなみ	浜波	胖波
武藏	Musashi	aibo	むさし	大姐头	武蔵	相棒
多摩	Tama	たま
凤翔	Houshou	ほうしょう	老板娘	鳳翔
福江	fukae	ふかえ
滨风	Hamakaze	はまかぜ	乳风	奶子风	小学生叛徒	浜風	浜风	玛修
速吸	Hayasui	はやすい
大凤	Taihou	たいほう	呆猴	塔威女神	大鳳	大鸟	太凤	太后	平胸萝莉	能登凤	萝莉凤	论外凤
松风	Matsukaze	まつかぜ	松風
舞风	Maikaze	まいかぜ	舞風
萨拉托加	Sara	Saratoga	サラトガ	萨拉
雾岛	Kirishima	きりしま	切麦狂魔	四傻	霧島
龙田	Tatsuta	たつた	龍田
睦月	Mutsuki	むつき	眭月	陆夫人	陆月
黑潮	Kuroshio	ggk	くろしお	谷小町	谷谷开	黒潮
春风	Harukaze	はるかぜ	春風
比睿	Hiei	ひえい	二傻	比叡
甘古特	Ganguto	Гангут	Гангут два	ガングート	十月革命	同志	哥萨克	大同志	大响	大毛子
白雪	Shirayuki	しらゆき
初风	Hatsukaze	はつかぜ	初風
霰	Arare	あられ	阿拉蕾
初月	Hatsuduki	はつづき
卯月	Uduki	pion	pyon	うづき	兔子	卬月	卵月	卵用	噗噗
佐渡	Sado	さど
山云	Yamagumo	やまぐも	山雲
纳尔逊	Nelson	ネルソン	奈尔逊	巨傻	纳孙	老纳	老衲
山风	Yamakaze	やまかぜ	山風
子日	Nenohi	ねのひ
塔什干	Tashukento	Ташкент	タシュケント	中不点	中号同志	中同志	同志	塔塔	小同志	小毛子	毛驱	脱了很大同志
占守	Shimushu	しむしゅ	西姆咻
伊势	14	Ise	いせ	伊勢
天雾	Amagiri	あまぎり	天霧
俾斯麦	Bismarck	B子	bis	bsm	俾四麦	俾斯曼	俾斯麥	四胖	波斯猫	胖胖胖胖	麦姐	麦子
云龙	Unryuu	うんりゅう	老李	雲龍
爱宕	Atago	あたご	愛宕	爱大狗
伊14	14	I-14	I14	い14	イヨ	伊佑
皇家方舟	Ark	Ark Royal	アークロイヤル	剑鱼组	方舟	方舟子
吕500	500	low酱	ro酱	ろ500	ろーちゃん	ろ酱	吕	吕酱	啰酱
隼鹰	Junnyou	じゅんよう	酒鬼
冲波	Okinami	おきなみ	沖波	蔡英文
衣笠	Kinugasa	きぬがさ
夕立	Yuudachi	p.*o.*i	poi	ぽい	ゆうだち	婆姨	狂犬	狗子
木曾	Kiso	きそ	曾哥	曾爷
择捉	Etorofu	えとろふ	エロトフ	択捉	擇足
Z1	Leberecht Maass	レーベレヒト・マース
弥生	Yayoi	やよい
初春	Hatsuharu	はつはる
大井	Ooi	おおい	冬马
酒匂	Sakawa	さかわ	酒妹	酒韵
吹雪	Fubuki	whobuki	ふぶき	吹吹	欠雷
扎拉	Zara	zala	ザラ
神风	Kamikaze	かみかぜ	神風
伊168	168	I168	い168	伊姆亚	伊姆鸭
龙骧	RJ	Ryuujou	りゅうじょう	砧板	菜板	龍驤
矶波	Isonami	いそなみ	磯波
绫波	0波	Ayanami	あやなみ	綾波	绫包子	退环境	鬼神	黑豹
路易吉	504	Luigi	Luigi Torelli	UIT-25	伊504	路易吉·托雷利
响	Bep	Hibiki	Верный	ひびき	不死鸟	信赖	同志	响爷	小同志	響
特斯特	CT	Commandant Teste	TST	Teste	test	塔斯特	法国poi	法国水母	特斯塔	特斯拉	特斯特司令官	特斯特长官	高露洁
明石	Akashi	あかし	明老板
菊月	Kikuduki	きくづき
清霜	Kiyoshimo	bb霜	きよしも
黎塞留	Richelieu	リシュリュー	主教	法国BB	理解	黎姐
青叶	Aoba	あおば	记者	青葉
涟	Sazanami	さざなみ	漣
名取	Natori	なとり
波拉	Pola	ポーラ	酒鬼
藤波	Fujinami	ふじなみ
海风	Umikaze	うみかぜ	海風
天龙	Tenryuu	てんりゅう	天龍
大鹰	Kasuga Maru	Taiyou	かすがまる	たいよう	春日丸	索尼子
齐柏林	780	GZ	Graf	Graf Zeppelin	Zeppelin	齐柏林伯爵
赤城	Akagi	あかぎ	吃撑
对马	Tsushima	つしま	临安	対馬	対马	汁吸马	温柔少女	魔性海防
大淀	Ooyodo	おおよど	任务娘	大屁股	大波胡	大腚
大和	Yamato	やまと	伞姐	压码头	宇宙战舰	打伞的大姐姐	旅馆
伊400	400	I400	い400	しおん
朝霜	Asashimo	あさしも	赵爽
矢矧	Yahagi	やはぎ	中和	矢引	矢矢引	蚯蚓
秋津丸	Akitsumaru	あきつまる	あきつ丸	僵尸	僵尸丸	烈风拳
岸波	Kishinami	きしなみ
春雨	Harusame	はるさめ
大东	Daitou	だいとう	大東
三隈	3V	Mikuma	くまりんこ	みくま	三熊	枪给
照月	Teruduki	てるづき	电气脉冲锤	电气锤
秋云	Akigumo	あきぐも	秋雲
鸟海	Choukai	ちょうかい	乌梅	乌海	鳥海
伊401	401	I401	い401	しおい
大鲸	Taigei	たいげい	买菜时雨	大鯨	太给	鲸
神通	Jintsuu	じんつう	女武神	精子
天城	Amagi	あまぎ
香取	Katori	かとり
长波	Naganami	zhangbo	ながなみ	長波
筑摩	Chikuma	ちくま	七姑妈
U511	511	U	U酱	ゆ-511	ゆ酱
望月	Mochiduki	もちづき
大潮	Ooshio	おおしお
凉月	Suzutsuki	すずつき	水泥姬	涼月	凉月
胧	Oboro	おぼろ	朧	蟹
苍龙	Souryuu	そうりゅう	蒼龍
时津风	Tokitsukaze	ときつかぜ	失禁风	时劲风	時津風
陆奥	Mutsu	むつ	三号炮塔	肉奥	陸奥
江风	Kawakaze	かわかぜ	口-口风	江風
鬼怒	Kinu	きぬ
神威	Kamoi	かもい
飞鹰	Hiyou	ひよう	飛鷹
阳炎	Kagerou	かげろう	肠炎	陽炎
长月	Nagatsuki	ながつき	長月
川内	Sendai	せんだい	仙台	夜战八嘎	夜战笨蛋
文月	Fumiduki	ふみづき
狭雾	Sagiri	さぎり	狭霧
瑞凤	Zuihou	ずいほう	女儿	瑞鳳
丛云	Murakumo	むらくも	叢雲
不知火	Shiranui	しらぬい	火爷
能代	Noshiro	のしろ
利根	Tone	とね	吾辈
伊8	18	8	8酱	I-8	I8	い8	哈酱	蛤酱
榛名	Haruna	はるな	哈露娜	哈鲁娜	小天使	春菜	棒各
亲潮	Oyashio	おやしお	親潮
高波	Takanami	たかなみ
羽黑	Haguro	はぐろ	羽黒
国后	Kunashiri	くなしり	国後
水无月	Minaduki	みなづき	水無月
谷风	Tanikaze	たにかぜ	谷風
秋津洲	Akitsushima	kamo	あきつしま	卵用洲	大艇
加古	Kako	かこ
秋月	Akiduki	あきづき	小和
岛风	Shimakaze	しまかぜ	島風
敷波	Shikinami	しきなみ
伊26	26	I26	い26	妮姆	尼姆
金刚	Kongou	こんごう	大傻	金剛
由良	Yura	ゆら
翔鹤	Shoukaku	しょうかく	太太	翔鶴
熊野	Kumano	くまの
西南风	Libeccio	lib	libe	リベッチオ	利贝
五月雨	Samidare	さみだれ
贾维斯	Jervis	ジャーヴィス	小傻	小爽	小贾	杰维斯	爽哥	爽爽子	爽驱
五十铃	12铃	500	Isuzu	いすず	五十鈴	本子王
如月	Kisaragi	きさらぎ
日向	Hyuuga	ひゅうが
电	Inaduma	いなづま	电酱	電
霞	Kasumi	かすみ	霞妈
罗伯茨	P90	Roberts	SAM	SBR	Samuel	Samuel B. Roberts	萝卜
鹿岛	Kashima	かしま	鹿島
天津风	Amatsukaze	tenga	あまつかぜ	吊带	吊带风	天津風	疼啊	锅风
伊19	19	I19	い19	一库
妙高	Myoukou	みょうこう	颜艺
雪风	Yukikaze	ゆきかぜ	丹阳	亲王	祥瑞	雪亲王	雪風
阿武隈	AWW	Abukuma	あぶくま	八万钢	阿布库玛	阿布熊	雪菜
卷云	Makigumo	まきぐも	小卷	巻云	巻雲
伊58	58	I58	い58	苦瓜	锅鸭
雷	Ikaduchi	いかづち	雷妈
飞龙	Hiryuu	ひりゅう	飛龍
白露	Shiratsuyu	しらつゆ	一级棒
厌战	Warspite	ウォースパイト	老太太	老太婆	老奶奶
松轮	Matsuwa	まつわ	松輪
潮	Ushio	うしお
矶风	Isokaze	いそかぜ	磯風	驱逐王
夕云	Yuugumo	ゆうぐも	夕雲
早霜	Hayashimo	はやしも
皋月	Satsuki	さつき	皐月
马路油	Maruyu	まるゆ	三式潜航输送艇	丸输	战神	马战神	马陆油
龙凤	Ryuuhou	りゅうほう	龍鳳
罗马	LowMA	Roma	low马	ローマ	雪人
瑞鹤	Zuikaku	ずいかく	ひゅー	小姨子	瑞瑞	瑞鶴
最上	Mogami	もがみ
阿贺野	Agano	ahy	あがの	阿賀野
若叶	Wakaba	わかば	若葉
村雨	Murasame	むらさめ
千代田	Chiyoda	ちよだ	浮不起来	爽代田
Z3	Max Schultz	マックス・シュルツ	馬克斯·舒爾茨	马克思
朝风	Asakaze	あさかぜ	朝風
初霜	Hatsushimo	はつしも
野分	Nowaki	のわき
浦风	Urakaze	うらかぜ	浦風
祥凤	Shouhou	しょうほう	祥鳳
伊13	113	13	I13	い13	小瞳	瞳酱
岚	Arashi	あらし	嵐
北方水姬	
装甲空母姬	
防空埋护姬	凉月	埋	埋姬	小埋	水泥	深海凉月
欧洲栖姬	欧洲	欧洲姬
集积地栖姬	DJ	JJD
中枢栖姬	中枢	中枢姬
水母水姬	
战舰栖姬	屁股	美尻	院长
驱逐古鬼	古鬼
驱逐栖姬	春雨	深海春雨
运河栖姬	运河
潜水新栖姬	幼女	辛弃疾
空母ヲ级	wo
空母栖姬	主任
海峡夜栖姬	
防空栖姬	爽妻	防空	防空姬	防空鸡
潜水栖姬	
离岛栖鬼	离岛	黑loli
战舰ル级	ru	撸爷
中间栖姬	中途岛	中间
战舰タ级	TA姐	ta	塔	塔姐
深海鹤栖姬	深海瑞鹤	火鸡	瑞鹤	鹤	鹤姬	鹤栖姬
欧洲水姬	欧洲
轻巡栖鬼	那珂	那珂野	那贺野
轻巡栖姬	深海神通	神通
重巡栖姬	重巡	重巡鸡
战舰法栖姬	仏棲姬	法姬	法鸡
战舰レ级	re	孙红雷	雷爷
泊地水鬼	
彼岸栖姬	彼岸
南方栖鬼	
北方栖姬	北方	小北	小北方
港湾栖姬	港湾
泊地栖鬼	
深海海月姬	sara	月姬	核爆姬	海月	海月姬	深海萨拉
驱逐水鬼	深海萩风	萩风
飞行场姬	机场	飞行场
护卫栖水姬	干贝	深海甘比尔湾	贝
水母栖姬	水母姬	深海瑞穗	瑞穗
空母水鬼	副主任	教授	深海翔鹤	翔鹤
护卫栖姬	护卫鸡	深海大鹰
战舰水鬼	深海长门	理事长
深海双子栖姬	双子
港湾水鬼	港湾
